NO ./texture/north.xpm
SO ./texture/south.xpm
WE ./texture/west.xpm
EA ./texture/east.xpm

F 118,118,118
C 110,177,255

11111111111
10000000001
10000100001
10001010001
10010001001
10100N00101
10010001001
10001010001
10000100001
10000000001
11111111111