NO ./texture/north.xpm
SO ./texture/south.xpm
WE ./texture/west.xpm
EA ./texture/east.xpm

F 118,118,118
C 225,3a0,0

111111
100101
101001
1100N1
111111