NO ./texture/north.xpm
SO ./texture/south.xpm
WE ./texture/west.xpm
EA ./texture/east.xpm

F 100,100,0
C 110,111,,,,254

111111
100101
101001
1100N1
111111