NO ./texture/north.xpm
SO ./texture/south.xpm
WE ./texture/west.xpm
EA ./texture/east.xpm

F 118,118,118
C 110,177,255

111111
100101
101001
110001
111111
110111
100101
101001
110001
111111

111111
100101
101001
1100N1
111110